10 20
11111111111111111111
10101000001000000001
10000010100011111101
10111110111111111101
10100000000000000101
11111111111111110101
10100000000000000101
10111111111111011111
100000000000000000X1
11111111111111111111
